5
E,V,E,E,V
E,V,E,E,E
E,V,E,E,E
V,S,V,V,V
E,E,V,E,E
E,E,E,E,E
E,E,E,E,E
V,V,E,M,E
E,E,V,E,W
E,E,V,E,E
V,V,V,E,E
E,E,V,E,E
W,E,I,E,E
V,V,V,E,E
E,E,E,E,E
E,E,V,E,E
E,E,V,E,E
E,F,V,V,V
E,B,E,E,E
E,V,E,E,E
E,E,V,E,O
E,E,V,E,E
V,V,V,E,E
E,E,I,E,E
E,E,W,E,E
E,E,W,E,E
E,E,E,E,E
Z,L,I,V,C
E,E,E,E,E
E,E,E,E,E