5
E,E,V,E,E
E,E,V,E,E
E,E,S,E,E
E,E,V,E,E
E,E,V,E,E
E,E,E,E,E
E,E,E,E,E
E,E,E,E,E
E,E,E,E,E
E,E,E,E,E
E,E,E,E,E
E,E,E,E,E
E,E,E,E,E
E,E,E,E,E
E,E,E,E,E
E,E,V,E,E
E,E,V,E,E
E,E,V,E,E
E,E,V,E,E
E,E,V,E,E
E,E,V,E,E
E,E,V,E,E
E,E,V,E,E
E,E,V,E,E
E,E,V,E,E
E,E,V,E,E
E,E,V,E,E
E,E,Z,E,E
E,E,V,E,E
E,E,V,E,E